2,0,0,0,0,0,0,0,0,0,0,7,0,0,5,0,0,0,8,0,0,0,0,9,1,0,0,0,0,0,8,5,1,0,0,4,1,0,0,8
2,0,0,0,0,0,0,0,0,0,9,6,0,0,0,0,0,0,8,0,0,9,5,6,4,5,1,0,0,0,7,0,0,0,0,0,4,1,0,8
2,0,0,0,0,0,0,0,0,0,0,0,0,0,0,0,0,0,8,0,0,0,0,0,0,0,0,0,0,9,6,0,0,0,0,0,10,3,0,0
2,0,0,0,0,0,0,0,0,0,0,0,9,1,0,0,0,0,8,0,0,0,0,0,0,0,0,0,0,0,0,0,0,0,9,5,10,4,1,0
2,0,0,0,0,0,0,9,5,5,1,0,0,4,1,0,0,0,8,5,1,0,0,0,0,0,0,0,9,5,1,0,0,0,0,0,0,0,4,5
2,0,0,0,0,0,0,0,0,0,4,5,0,0,0,0,0,0,8,10,4,1,0,0,0,0,0,0,0,0,4,1,0,0,0,0,0,0,0,8
2,0,0,0,0,0,0,0,0,0,0,8,0,0,0,0,0,0,8,10,10,2,0,0,0,0,0,0,0,0,0,0,0,0,0,0,0,0,0,8
2,0,0,9,1,0,0,0,0,0,0,8,5,5,5,1,0,0,8,3,0,0,0,0,0,9,1,0,0,0,0,0,9,5,5,1,0,0,0,8
2,0,0,0,4,5,1,0,0,0,0,7,10,10,10,0,0,0,8,4,5,1,0,0,0,0,4,5,1,0,9,5,6,0,0,0,0,0,0,8
2,0,0,0,0,0,0,0,0,0,9,6,10,10,0,0,0,0,7,10,0,0,0,0,0,0,0,0,0,0,0,2,0,0,0,0,0,0,0,7
2,0,0,0,0,0,0,0,9,5,6,10,0,0,0,0,9,5,6,0,0,0,0,0,0,0,0,0,0,0,0,3,0,0,0,0,0,0,9,6
2,0,0,0,0,0,0,0,7,10,0,0,0,0,0,0,0,10,10,0,0,0,0,0,0,0,0,0,0,9,5,4,5,1,0,0,9,5,6,10
2,0,0,0,0,0,9,5,6,0,0,0,0,9,5,1,0,0,0,0,0,0,0,0,0,0,0,0,0,0,0,0,0,10,2,0,0,0,0,8
2,0,0,0,9,5,6,10,0,0,0,0,9,6,0,0,0,0,0,0,0,0,0,0,0,9,5,1,0,0,0,0,0,0,3,0,0,0,0,8
3,0,0,0,0,0,0,0,0,0,0,0,0,0,0,0,0,0,0,0,0,0,0,0,0,0,0,0,0,0,0,0,0,0,4,1,0,0,0,7
4,5,5,5,5,5,5,5,1,0,0,9,0,0,0,0,9,5,5,5,1,0,0,0,0,0,0,0,9,5,1,0,0,0,4,1,0,0,9,6
2,0,0,0,0,0,0,0,0,0,0,7,0,0,5,0,0,0,8,0,0,0,0,9,1,0,0,0,0,0,8,5,1,0,0,4,1,0,0,8
2,0,0,0,0,0,0,0,0,0,9,6,0,0,0,0,0,0,8,0,0,9,5,6,4,5,1,0,0,0,7,0,0,0,0,0,4,1,0,8
2,0,0,0,0,0,0,0,0,0,0,0,0,0,0,0,0,0,8,0,0,0,0,0,0,0,0,0,0,9,6,0,0,0,0,0,10,3,0,0
2,0,0,0,0,0,0,0,0,0,0,0,9,1,0,0,0,0,8,0,0,0,0,0,0,0,0,0,0,0,0,0,0,0,9,5,10,4,1,0
2,0,0,0,0,0,0,9,5,5,1,0,0,4,1,0,0,0,8,5,1,0,0,0,0,0,0,0,9,5,1,0,0,0,0,0,0,0,4,5
2,0,0,0,0,0,0,0,0,0,4,5,0,0,0,0,0,0,8,10,4,1,0,0,0,0,0,0,0,0,4,1,0,0,0,0,0,0,0,8
2,0,0,0,0,0,0,0,0,0,0,8,0,0,0,0,0,0,8,10,10,2,0,0,0,0,0,0,0,0,0,0,0,0,0,0,0,0,0,8
2,0,0,9,1,0,0,0,0,0,0,8,5,5,5,1,0,0,8,3,0,0,0,0,0,9,1,0,0,0,0,0,9,5,5,1,0,0,0,8
2,0,0,0,4,5,1,0,0,0,0,7,10,10,10,0,0,0,8,4,5,1,0,0,0,0,4,5,1,0,9,5,6,0,0,0,0,0,0,8
2,0,0,0,0,0,0,0,0,0,9,6,10,10,0,0,0,0,7,10,0,0,0,0,0,0,0,0,0,0,0,2,0,0,0,0,0,0,0,7
2,0,0,0,0,0,0,0,9,5,6,10,0,0,0,0,9,5,6,0,0,0,0,0,0,0,0,0,0,0,0,3,0,0,0,0,0,0,9,6
2,0,0,0,0,0,0,0,7,10,0,0,0,0,0,0,0,10,10,0,0,0,0,0,0,0,0,0,0,9,5,4,5,1,0,0,9,5,6,10
2,0,0,0,0,0,9,5,6,0,0,0,0,9,5,1,0,0,0,0,0,0,0,0,0,0,0,0,0,0,0,0,0,10,2,0,0,0,0,8
2,0,0,0,9,5,6,10,0,0,0,0,9,6,0,0,0,0,0,0,0,0,0,0,0,9,5,1,0,0,0,0,0,0,3,0,0,0,0,8
3,0,0,0,0,0,0,0,0,0,0,0,0,0,0,0,0,0,0,0,0,0,0,0,0,0,0,0,0,0,0,0,0,0,4,1,0,0,0,7
4,5,5,5,5,5,5,5,1,0,0,9,0,0,0,0,9,5,5,5,1,0,0,0,0,0,0,0,9,5,1,0,0,0,4,1,0,0,9,6
2,0,0,0,0,0,0,0,0,0,0,7,0,0,5,0,0,0,8,0,0,0,0,9,1,0,0,0,0,0,8,5,1,0,0,4,1,0,0,8
2,0,0,0,0,0,0,0,0,0,9,6,0,0,0,0,0,0,8,0,0,9,5,6,4,5,1,0,0,0,7,0,0,0,0,0,4,1,0,8
2,0,0,0,0,0,0,0,0,0,0,0,0,0,0,0,0,0,8,0,0,0,0,0,0,0,0,0,0,9,6,0,0,0,0,0,10,3,0,0
2,0,0,0,0,0,0,0,0,0,0,0,9,1,0,0,0,0,8,0,0,0,0,0,0,0,0,0,0,0,0,0,0,0,9,5,10,4,1,0
2,0,0,0,0,0,0,9,5,5,1,0,0,4,1,0,0,0,8,5,1,0,0,0,0,0,0,0,9,5,1,0,0,0,0,0,0,0,4,5
2,0,0,0,0,0,0,0,0,0,4,5,0,0,0,0,0,0,8,10,4,1,0,0,0,0,0,0,0,0,4,1,0,0,0,0,0,0,0,8
2,0,0,0,0,0,0,0,0,0,0,8,0,0,0,0,0,0,8,10,10,2,0,0,0,0,0,0,0,0,0,0,0,0,0,0,0,0,0,8
2,0,0,9,1,0,0,0,0,0,0,8,5,5,5,1,0,0,8,3,0,0,0,0,0,9,1,0,0,0,0,0,9,5,5,1,0,0,0,8
2,0,0,0,4,5,1,0,0,0,0,7,10,10,10,0,0,0,8,4,5,1,0,0,0,0,4,5,1,0,9,5,6,0,0,0,0,0,0,8
2,0,0,0,0,0,0,0,0,0,9,6,10,10,0,0,0,0,7,10,0,0,0,0,0,0,0,0,0,0,0,2,0,0,0,0,0,0,0,7
2,0,0,0,0,0,0,0,9,5,6,10,0,0,0,0,9,5,6,0,0,0,0,0,0,0,0,0,0,0,0,3,0,0,0,0,0,0,9,6
2,0,0,0,0,0,0,0,7,10,0,0,0,0,0,0,0,10,10,0,0,0,0,0,0,0,0,0,0,9,5,4,5,1,0,0,9,5,6,10
2,0,0,0,0,0,9,5,6,0,0,0,0,9,5,1,0,0,0,0,0,0,0,0,0,0,0,0,0,0,0,0,0,10,2,0,0,0,0,8
2,0,0,0,9,5,6,10,0,0,0,0,9,6,0,0,0,0,0,0,0,0,0,0,0,9,5,1,0,0,0,0,0,0,3,0,0,0,0,8
3,0,0,0,0,0,0,0,0,0,0,0,0,0,0,0,0,0,0,0,0,0,0,0,0,0,0,0,0,0,0,0,0,0,4,1,0,0,0,7
4,5,5,5,5,5,5,5,1,0,0,9,0,0,0,0,9,5,5,5,1,0,0,0,0,0,0,0,9,5,1,0,0,0,4,1,0,0,9,6
